i: 17
j: 80
BBBBBBBBBBBBBBBBBBBBBBBBBBBBBBBBBBBBBBBBBBBBBBBBBBBBBBBBBBBBBBBBBBBBBBBBBBBBBBBB
B             BOO                    O BD OO         BBB   BBB   BBB   BBB  BBBB
B             BOO                    OOB  OO          B     B     B     B    BBB
B           OOBOO                      BBBBBB           O O   O O   O O       BB
B           OOBBBBBBBBB   BB           BBBBBBB         OOOOO OOOOO OOOOO       B
B       BBBBBBB       O                BBBBBBBBBBBB     O O   O O   O O        B
B           OOO       O        BB                 B                            B
BBBB        OOO       O                           BBBBB     B     B     B    OOB
BBBBB                 BBBBOOOOOOOOOOBBBBBBB       B                          OOB
BBBBBBB   BB   BB   BBBB            OOOBBBBB      B                          BBB
BBLLBBBLLLLLLLLLLLLLBBBB        BB  OOOBBBBBBB  BBB                     O      B
BBBBBBBBBBBBBBBBBBBBBBBB    BBBBBBBBBBBBOOO   OO         OO             B      B
BLLBBBK    OOO   OOO       BBBBBBBBBB   OOO   OO         BB         O     O    B
BBBBBB                    BBBBLLBBBBB   OOO   OO   OO               B     B   OB
BB  BB                    BBBBBBBBBBBBBBBBB   BB   BB           OO            OB
BBB BB  BBB   BBB   BBB  BBLLLBBLLBBBBBB                        BB            BB
BBBBBBLLLLLLLLLLLLLLLLLLLBBBBBBBBBBLLLBBLLLLLLLLLLLLLLLLLLLLLLLLLLLLLLLLLLLLLLLB
Path length: 7
Path to sprites: sp1.txt
Path length: 7
Path to objs: ob1.txt
Path length: 8
Path to next: map2.txt
Path length to background: 8
Path to background: back.bmp