i: 17
j: 80
BBBBBBBBBBBBBBBBBBBBBBBBBBBBBBBBBBBBBBBBBBBBBBBBBBBBBBBBBBBBBBBBBBBBBBBBBBBBBBBB
B             B                        B             BBB   BBB   BBB   BBB  BBBB
B             B                        B              B     B     B     B    BBB
B             B                        BBBBBB                                 BB
B             BBBBBBBBB   BB           BBBBBBB                                 B
B       BBBBBBB                        BBBBBBBBBBBB                            B
B                              BB                 B                            B
BBBB                                              BBBBB     B     B     B      B
BBBBB                 BBBB          BBBBBBB       B                            B
BBBBBBB   BB   BB   BBBB               BBBBB      B                          BBB
BBLLBBBLLLLLLLLLLLLLBBBB        BB     BBBBBBB  BBB                            B
BBBBBBBBBBBBBBBBBBBBBBBB    BBBBBBBBBBBB                                B      B
BLLBBB                     BBBBBBBBBB                    BB                    B
BBBBBB                    BBBBBBLLBBB                               B     B    B
BB  BB                    BBBBBBBBBBBBBBBBB   BB   BB                          B
BBB BB  BBB   BBB   BBB  BBLLLBBBLBBBBBB                        BB            BB
BBBBBBLLLLLLLLLLLLLLLLLLLBBBBBBBBBBLLLBBLLLLLLLLLLLLLLLLLLLLLLLLLLLLLLLLLLLLLLLB
Path length: 7
Path to sprites: sp1.txt
Path length: 7
Path to objs: ob1.txt
Path length: 8
Path to next: map2.txt
Path length to background: 8
Path to background: back.bmp